Username: jesusking	Password: z3nUDa1d*^
Username: tony10	Password: Z*0B24XhOC
Username: riveradarren	Password: c#a)9KVRHd
Username: garyrandolph	Password: 4@(0N^qdL9
Username: hlane	Password: UG3Dneg5$r
Username: riversanthony	Password: +f*wBZi*0o
Username: robert15	Password: B!1(OixB&3
Username: chad70	Password: +Bsw+E!m!2
Username: forbesdavid	Password: &z1l5MlZM#
Username: xgordon	Password: m8MdDGsG%5
Username: martinjacob	Password: mtVsDgYs%8
Username: jenniferhenson	Password: p$2xOPoSBo
Username: jhaynes	Password: f$zh6B^qoP
Username: jroberts	Password: 4m&5mJ+mCq
Username: rfloyd	Password: fX7YXGt0q%
Username: yrobinson	Password: B)b5p8Anz4
Username: barrlori	Password: !0kj77HtJf
Username: brent97	Password: 9qW*L^B4^P
Username: aprilbell	Password: (Yk0VCpQus
Username: jason22	Password: PG46B#HvX#
