Username: jacksonashley	Password: 8b3d!vHf#z
Username: browndiana	Password: ohC_rYO+!0
Username: heather78	Password: l30F@)Yn%P
Username: hamptonsamantha	Password: W+Re2LI+vr
Username: joshua36	Password: u8xp#TNs&4
Username: pamela86	Password: +e9dwdXzk+
Username: jefferyjones	Password: S&y6G20(za
Username: jeffrey02	Password: YA0VU(Ax%)
Username: aprilsmith	Password: +2oSkjjTO6
Username: lynn27	Password: X8P6VaaaR%
Username: jacksonronald	Password: 0Fw3D!UvT(
Username: robertalvarado	Password: +_7vIpvgGw
Username: robertsjennifer	Password: $7H9up0i!x
Username: amymeyer	Password: m#0hIvf+*S
Username: robertslawrence	Password: !&vdscZnZ6
Username: allenpamela	Password: *5&ZEJcP33
Username: perezerin	Password: $(sCrJsVR5
Username: lewisryan	Password: %7%OwApI+j
Username: sonya40	Password: zg8B9dE8n(
Username: esmith	Password: $%yZ5cIlti
